###########
#@        #
#   bb    #
#    b ## #######
#   b         ..#
#     #       ..#
#################