  #####
###   #
#.@b  #
### b.#
#.##b #
# # . ##
#b  bb.#
#   .  #
########